111111111111111111111111111111
10MMMMMMMMM1111111111111111111
10000RMMMMM1111111111111111111
1MM0M00M00M1111111111111111111
10M00MR000R1111111111111111111
10M00MMMMM000G1111111111111111
10M000000M01111111111111111111
1MMMMMMM000000AC111111
1111111111000001111111
111111111111111111111111111111
111111111111111111111111111111
111111111111111111111111111111
